5 10
0 0 0 0 0 5 0 0 0 0
0 0 0 0 0 9 0 0 0 0
0 0 0 0 0 9 9 9 9 7
0 0 0 0 0 0 0 0 0 0
0 0 0 0 0 0 0 0 0 0
2
3 0 0 9
4 9 0 9
